NO assets/textures/static/walls/wall53.png
SO assets/textures/static/walls/wall54.png
WE assets/textures/static/walls/wall55.png
EA assets/textures/static/walls/wall56.png

F 184,113,39
C 51,198,227

11111111111111111111111111111
10000000000000000000000000001
10000000000000000000000000001
10000000000000000000000000001
10000000000000000000000000001
10000000000000000000000000001
10000000000000000000000000001
10000000000000000000000000001
10000000000000X00000000000001
10000000000000000000000000001
10000000000000000000000000001
10000000000000000000000000001
10000000000000000000000000001
10000000000000000000000000001
10000000000000000000000000001
10N00000000000000000000000001
11111111111111111111111111111
