NO assets/textures/static/walls/wall25.png
SO assets/textures/static/walls/wall26.png
WE assets/textures/static/walls/wall27.png
EA assets/textures/static/walls/wall28.png


F 0,0,0
C 0,0,0

111111111111111111111111111111
100000000000000000000000000001
121111111111110000000011100001
100000000000000000110000000001
100000000000000000110000000001
100000000001000000000100000001
101111110001110110000100100001
100000000000000000000111110001
101111110000100000000100000001
101000010000100000000000000001
101000010000100111111110000001
1010000100001000000000200000N1
101000010000100111111110000001
100000020000100000000020000001
100000110000100110000110000001
100000110000100000000000000001
100000000000100000000000000001
111111111111111111111111111001
121212121212111111111111111111
111111111111111111111111111111
