NO assets/textures/static/walls/wall33.png
SO assets/textures/static/walls/wall34.png
WE assets/textures/static/walls/wall35.png
EA assets/textures/static/walls/wall36.png

F 184,113,39
C 51,198,227


1111 1111
10N1 1001
1111 1111
