big map:

1111111111111111
100N000000000001
1000000000000001
1000000000000001
1000000000000001
1000000000000001
1000000000000001
1000000000000001
1000000000000001
1000000000000001
1000000000000001
1000000000000001
1000000000000001
1000000000000001
1000000000000001
1111111111111111


small map:

111111
10N001
100001
100001
111111


test map:
        1111111111111111111111111
        1002000000110000000000001
        1011000001110000000000001
        1001000000020000000000001
111111111011000001110000000000001
100000000011000001110111112111111
11112111111111211100000010001
11110111111111011101010010001
11000000110101011100000010001
10000000000000001100000010001
10000000000000001101010010N01
1100000111010101111101111000111
11110111 1110101 101111010001
11111111 1111111 111111111111