NO ./assets/textures/wall0.png
SO ./assets/textures/wall1.png
WE ./assets/textures/wall2.png
EA ./assets/textures/wall3.png

F 0,0,0
C 255,255,255

        1111111111111111111111111
        1002000000110000000000001
        1011000001110000000000001
        1001000000020000000000001
111111111011000001110000000000001
100000000011000001110111112111111
11112111111111211100000010001
11110111111111011101010010001
110000001101010111000000100011111
100000000000000011000000100010001
10000000000000001101010010N010001
110000011101010111110111100010001
11110111 1110101 1011110100020001
11111111 1111111 1111111111111111