NO ./assets/textures/static/wall0.png
SO ./assets/textures/static/wall1.png
WE ./assets/textures/static/wall2.png
EA ./assets/textures/static/wall3.png

F 0,0,0
C 255,255,255

        1111111111111111111111111
        1002000000110000000000001
        101100000111000000X000001
        1001000000020000000000001
111111111011000001110000000000001
100000000011000001110111112111111
11112111111111211100000010001
11110111111111011101010010001
11000000110101011100000010X01
10000000000000001100000010001
10000000000000001101010010001
11000001110101011111011110N0111
11110111 1110101 101111010001
11111111 1111111 111111111111